{
    "tiles" : [ [0, 1, 1, 1, 1, 1, 0 ],
                [1, 1, 1, 1, 1, 1, 1 ],
                [1, 1, 1, 1, 1, 1, 1 ],
                [1, 1, 1, 1, 1, 1, 1 ],
                [1, 1, 1, 1, 1, 1, 1 ],
                [0, 1, 1, 1, 1, 1, 0 ],
                [0, 0, 0, 0, 0, 0, 0 ] ],
    
    "myHighScore": 0,
    "lifeAvatar" : 350,
    "lifeEnemy" : 270,
    "offset": 47,
    "basedEnemy" : 2,
    "movesToEnemy": 1,
}