{
    "tiles" : [ [1, 1, 1, 1, 1, 1, 1 ],
                [1, 1, 1, 1, 1, 1, 1 ],
                [0, 1, 1, 1, 1, 1, 0 ],
                [0, 1, 1, 1, 1, 1, 0 ],
                [1, 1, 1, 1, 1, 1, 1 ],
                [1, 1, 1, 1, 1, 1, 1 ],
                [0, 0, 0, 0, 0, 0, 0 ] ],
    
    "lifeAvatar" : 350,
    "lifeEnemy" : 270,
    "movesToEnemy": 2,
}