{
    "tiles" : [ [1, 1, 1, 1, 1, 1, 1 ],
               [1, 1, 1, 1, 1, 1, 1 ],
               [1, 1, 1, 1, 1, 1, 1 ],
               [1, 1, 1, 1, 1, 1, 1 ],
               [1, 1, 1, 1, 1, 1, 1 ],
               [0, 0, 0, 0, 0, 0, 0 ],
               [0, 0, 0, 0, 0, 0, 0 ] ],
    
    "myHighScore": 0,
    "lifeAvatar" : 100,
    "lifeEnemy" : 500,
    "offset": 90,
    "basedEnemy" : 1,
    "movesToEnemy": 1,
    
}
